11111111111111111
1P001111111111111
1100CC01111111111
10001101111111111
1C0C1111111111111
11100E11111111111
11111111111111111
11111111111111111
11111111111111111


