111111111111
1P0011100011
11000CCM1011
100011100011
1M0C11110011
111CC0E10011
111111111111
