111111111111
1P0011100011
11000CC01011
100011100011
100C11110011
111CC1E10011
111111111111
